11111111111
1E000C01011
1P00110C111
1110C000111
11111111111