11111111111
1E000001011
1P001100011
111000C0111
11111111111