1111111111
1E000C0101
1P00110C11
1110C00011
1111111111