1111111111111
100100P0000C1
1110011111001
1C1011E000001
1111111111111
