11111111111
1EC00C01011
100011PC001
1110C000111
11111111111