11111111111
1EC00C01101
1000111CP01
1110C000111
11111111111