11111
1E001
10001
10001
1P001
11111
