11111
1EE01
1C001
1C001
1P001
11111
