11111
1E001
1C001
1C001
10001
11111
