11111
1E001
1C001
1C111
1P1C1
11111
