11111
1E001
1C001
1C001
1PP01
11111
