11111
1E001
1C001
1C0
1P001
111
